"filename", "language", "Processing", "Java", "comment", "blank", "total"
"c:\Users\zyanr\Downloads\ProcessingCiv\ADTs.pde", "Processing", 155, 0, 7, 39, 201
"c:\Users\zyanr\Downloads\ProcessingCiv\Board.pde", "Processing", 661, 0, 6, 72, 739
"c:\Users\zyanr\Downloads\ProcessingCiv\BoardClickHandler.pde", "Processing", 143, 0, 1, 11, 155
"c:\Users\zyanr\Downloads\ProcessingCiv\Boundary.pde", "Processing", 99, 0, 4, 18, 121
"c:\Users\zyanr\Downloads\ProcessingCiv\City.pde", "Processing", 517, 0, 2, 69, 588
"c:\Users\zyanr\Downloads\ProcessingCiv\Civ.pde", "Processing", 388, 0, 2, 65, 455
"c:\Users\zyanr\Downloads\ProcessingCiv\GUI.pde", "Processing", 134, 0, 10, 25, 169
"c:\Users\zyanr\Downloads\ProcessingCiv\GenerationRules.pde", "Processing", 37, 0, 0, 7, 44
"c:\Users\zyanr\Downloads\ProcessingCiv\ProcessingCiv.pde", "Processing", 440, 0, 48, 91, 579
"c:\Users\zyanr\Downloads\ProcessingCiv\ProductionMenu.pde", "Processing", 108, 0, 16, 16, 140
"c:\Users\zyanr\Downloads\ProcessingCiv\Tech.pde", "Processing", 69, 0, 1, 8, 78
"c:\Users\zyanr\Downloads\ProcessingCiv\TechTree.pde", "Processing", 105, 0, 5, 12, 122
"c:\Users\zyanr\Downloads\ProcessingCiv\Tile.pde", "Processing", 172, 0, 4, 28, 204
"c:\Users\zyanr\Downloads\ProcessingCiv\out\ProcessingCiv$AttackingUnit.class", "Java", 0, 68, 0, 1, 69
"c:\Users\zyanr\Downloads\ProcessingCiv\out\ProcessingCiv$AxialCoord.class", "Java", 0, 26, 0, 0, 26
"c:\Users\zyanr\Downloads\ProcessingCiv\out\ProcessingCiv$BfsStrategy.class", "Java", 0, 6, 0, 0, 6
"c:\Users\zyanr\Downloads\ProcessingCiv\out\ProcessingCiv$Biome.class", "Java", 0, 18, 0, 1, 19
"c:\Users\zyanr\Downloads\ProcessingCiv\out\ProcessingCiv$BiomeRule.class", "Java", 0, 12, 0, 0, 12
"c:\Users\zyanr\Downloads\ProcessingCiv\out\ProcessingCiv$Board.class", "Java", 0, 362, 0, 0, 362
"c:\Users\zyanr\Downloads\ProcessingCiv\out\ProcessingCiv$BoardClickHandler.class", "Java", 0, 187, 0, 0, 187
"c:\Users\zyanr\Downloads\ProcessingCiv\out\ProcessingCiv$Boundary.class", "Java", 0, 71, 0, 0, 71
"c:\Users\zyanr\Downloads\ProcessingCiv\out\ProcessingCiv$City.class", "Java", 0, 242, 0, 2, 244
"c:\Users\zyanr\Downloads\ProcessingCiv\out\ProcessingCiv$Civ.class", "Java", 0, 212, 142, 5, 359
"c:\Users\zyanr\Downloads\ProcessingCiv\out\ProcessingCiv$CivName.class", "Java", 0, 27, 0, 0, 27
"c:\Users\zyanr\Downloads\ProcessingCiv\out\ProcessingCiv$CivilianUnit.class", "Java", 0, 161, 0, 3, 164
"c:\Users\zyanr\Downloads\ProcessingCiv\out\ProcessingCiv$CubeCoord.class", "Java", 0, 10, 0, 1, 11
"c:\Users\zyanr\Downloads\ProcessingCiv\out\ProcessingCiv$ElevationComparator.class", "Java", 0, 12, 0, 0, 12
"c:\Users\zyanr\Downloads\ProcessingCiv\out\ProcessingCiv$GUI.class", "Java", 0, 36, 0, 0, 36
"c:\Users\zyanr\Downloads\ProcessingCiv\out\ProcessingCiv$GUIElement.class", "Java", 0, 36, 0, 0, 36
"c:\Users\zyanr\Downloads\ProcessingCiv\out\ProcessingCiv$GUIType.class", "Java", 0, 14, 0, 0, 14
"c:\Users\zyanr\Downloads\ProcessingCiv\out\ProcessingCiv$HexEdge.class", "Java", 0, 15, 0, 0, 15
"c:\Users\zyanr\Downloads\ProcessingCiv\out\ProcessingCiv$ImprovementType.class", "Java", 0, 29, 0, 0, 29
"c:\Users\zyanr\Downloads\ProcessingCiv\out\ProcessingCiv$MeleeTravelStrategy.class", "Java", 0, 42, 0, 1, 43
"c:\Users\zyanr\Downloads\ProcessingCiv\out\ProcessingCiv$MeleeUnit.class", "Java", 0, 97, 0, 0, 97
"c:\Users\zyanr\Downloads\ProcessingCiv\out\ProcessingCiv$MenuType.class", "Java", 0, 12, 0, 0, 12
"c:\Users\zyanr\Downloads\ProcessingCiv\out\ProcessingCiv$Node.class", "Java", 0, 23, 0, 0, 23
"c:\Users\zyanr\Downloads\ProcessingCiv\out\ProcessingCiv$Option.class", "Java", 0, 22, 0, 0, 22
"c:\Users\zyanr\Downloads\ProcessingCiv\out\ProcessingCiv$Pair.class", "Java", 0, 25, 0, 0, 25
"c:\Users\zyanr\Downloads\ProcessingCiv\out\ProcessingCiv$PassiveTravelStrategy.class", "Java", 0, 28, 0, 1, 29
"c:\Users\zyanr\Downloads\ProcessingCiv\out\ProcessingCiv$ProductionMenu.class", "Java", 0, 53, 0, 0, 53
"c:\Users\zyanr\Downloads\ProcessingCiv\out\ProcessingCiv$RangedUnit.class", "Java", 0, 62, 23, 1, 86
"c:\Users\zyanr\Downloads\ProcessingCiv\out\ProcessingCiv$RelationshipState.class", "Java", 0, 19, 0, 0, 19
"c:\Users\zyanr\Downloads\ProcessingCiv\out\ProcessingCiv$ResourceType.class", "Java", 0, 16, 12, 0, 28
"c:\Users\zyanr\Downloads\ProcessingCiv\out\ProcessingCiv$TerrainTile.class", "Java", 0, 23, 0, 0, 23
"c:\Users\zyanr\Downloads\ProcessingCiv\out\ProcessingCiv$TerrainTileRule.class", "Java", 0, 12, 0, 0, 12
"c:\Users\zyanr\Downloads\ProcessingCiv\out\ProcessingCiv$Tile.class", "Java", 0, 32, 0, 0, 32
"c:\Users\zyanr\Downloads\ProcessingCiv\out\ProcessingCiv$TileType.class", "Java", 0, 65, 0, 0, 65
"c:\Users\zyanr\Downloads\ProcessingCiv\out\ProcessingCiv$Unit.class", "Java", 0, 186, 0, 0, 186
"c:\Users\zyanr\Downloads\ProcessingCiv\out\ProcessingCiv$UnitClass.class", "Java", 0, 16, 0, 0, 16
"c:\Users\zyanr\Downloads\ProcessingCiv\out\ProcessingCiv$UnitType.class", "Java", 0, 16, 0, 0, 16
"c:\Users\zyanr\Downloads\ProcessingCiv\out\ProcessingCiv$VisibilityStrategy.class", "Java", 0, 23, 0, 1, 24
"c:\Users\zyanr\Downloads\ProcessingCiv\out\ProcessingCiv$YieldType.class", "Java", 0, 16, 0, 0, 16
"c:\Users\zyanr\Downloads\ProcessingCiv\out\ProcessingCiv.class", "Java", 0, 238, 0, 1, 239
"c:\Users\zyanr\Downloads\ProcessingCiv\out\source\ProcessingCiv.java", "Java", 0, 3828, 109, 587, 4524
"c:\Users\zyanr\Downloads\ProcessingCiv\unit_AttackingUnit.pde", "Processing", 46, 0, 0, 5, 51
"c:\Users\zyanr\Downloads\ProcessingCiv\unit_CivilianUnit.pde", "Processing", 139, 0, 0, 15, 154
"c:\Users\zyanr\Downloads\ProcessingCiv\unit_MeleeUnit.pde", "Processing", 196, 0, 1, 22, 219
"c:\Users\zyanr\Downloads\ProcessingCiv\unit_RangedUnit.pde", "Processing", 121, 0, 0, 14, 135
"c:\Users\zyanr\Downloads\ProcessingCiv\unit_Unit.pde", "Processing", 449, 0, 7, 66, 522
"Total", "-", 3979, 6398, 400, 1188, 11965